11111111111111111
1C000000000000011
10111111111111101
100000000C000P001
11111111111111101
1E000000000000001
11111111111111111

