11111111111111
1C000000000011
10111111111111
100000000C0011
11111111011111
1E000000000P11
11111111111111

