111111111111111
1C000000000C001
101111111111001
100C01000000001
111011111111001
1E0010P000C0011
111111111111111

