1111111111
1001000001
1C11111101
1000C00001
1101111111
1E0000P001
1111111111

