1111111111111
100000C000001
1011111101011
1000000000001
1C11111111101
1E000P0000001
1111111111111

