1111111111111111
1C00000000000011
1011111111111111
100000C000000111
1111111101111111
1E000000P0000111
1111111111111111

