11111111111111111111
1CCCCCCCCCCCCCCCCCC1
1C1111111111111111C1
1CCCCCCCCCCCCCCCCCC1
1111111C1111111111C1
1CCCCCCCCCCCCC111111
1C111111111111CCCCC1
1CCCCCCCCCCCCCCCCCC1
1111111111C1111111C1
1ECCCCCCCCCCCCCCCPC1
11111111111111111111
