11111111111111111111
10CCC0C00C0000C00001
10111111101111111101
100C00C010C0000C00C1
11111111111111110101
1C0000000000000000C1
1C1111111111110111C1
1E000C000C00C00P0001
11111111111111111111

