1111111111111111111111111111111111
1000000000000000000000000000000001
1011111111111111111111111111111101
100000C000000000000000000000000011
1111111011111111111111111111111101
1C00000000000011111111111111111011
101111111111110000000000C000000001
1000000000001111111111111111111101
1111111111011000000000000000000001
1C00000000001111111111111111111011
1011111111111110000000000000000011
1000000C00000000111111111111111001
1111111111111111111111111111111101
1E0000000000000000000000000000P001
1111111111111111111111111111111111

