111111111111
100C00000001
101111111001
100000000001
111111111001
1E000P000001
111111111111

