111111111111111
1C0000000000011
101111111111011
100000C00000011
111111111110111
1E000P000000111
111111111111111

