1111111111111111
1000000000000001
1011111111111101
100000C000000001
1011111011111101
1E000000C0P00001
1111111111111111

